####################
#..................#
#................o.#
#...###......###...#
#...#..........#...#
#...#..........#...#
#...#..........#...#
#...#..........#...#
#...#..........#...#
#...#..........#...#
#...#..........#...#
#...#..........#...#
#...#..........#...#
#...#..........#...#
#...#..........#...#
#...#..........#...#
#...###......###...#
#.p................#
#..................#
####################