####################
#..................#
#................o.#
#..................#
#.#.#.#.#..#.#.#.#.#
#..................#
#..................#
#..................#
#..................#
#.#.#.#.#..#.#.#.#.#
#.#.#.#.#..#.#.#.#.#
#..................#
#..................#
#..................#
#..................#
#.#.#.#.#..#.#.#.#.#
#..................#
#.p................#
#..................#
####################