###################
#.................#
#...............o.#
#.................#
#.................#
#.................#
#.................#
#.................#
#.................#
#.................#
#.................#
#.................#
#.................#
#.................#
#.................#
#.................#
#.p...............#
#.................#
###################